55555555555555555555555555555555555555555555
55555555555555555555555555555555555555555555
55555555555555555555555555555555555555555555
55555555512222355551223555555555555555555555
555555512a    z2222a  z235555555555555555555
55555554                z2355555555555555555
55555554                  655555555122355555
5555555222                z23555512a  z23555
55555554                    655554      6555
5551222222222222          s8955554      6555
5554                    s895555554      6555
5554                    6555555554      6555
55578q                  z222355554    s89555
555554            sq        6555578888955555
5555578q          64        6555555555555555
5555512a        s894        6555555555555555
555554        s895578q      6555555555555555
5555578q      65555554      6555555555555555
55555554      z23555578q    6555555555555555
555555578q      65555554    6555555555555555
55555555578888889555555788889555555555555555
55555555555555555555555555555555555555555555
55555555555555555555555555555555555555555555
55555555555555555555555555555555555555555555