122222222222222222222222222222222223555555555555555
4                                  6555555555555555
4                                  6555555555555555
4                                  6555555555555555
4                                  z222235555555555
788888q                                 65555555555
5555554                                 65555555555
5555554                                 65555555555
5555554                                 65555555555
5555554                                 65555555555
555555788888888888888888888888888888888895555555555
555555555555555555555555555555555555555555555555555
555555555555555555555555555555555555555555555555555
555555555555555555555555555555555555555555555555555
555555555555555555555555555555555555555555555555555
555555555555555555555555555555555555555555555555555
555555555555555555555555555555555555555555555555555
555555555555555555555555555555555555555555555555555
