22222222222222222222222222222222222222222222222222222
2                         2                          2
2                         2                          2
2                                                    2
2                   2                                2
2                   2                                2
2         0         2     2                          2
2                         2                          2
2                         2                          2
2                                                    2
2                         2                          2
2                         2                          2
2                         2                          2
2                   2     2                          2
2                   2                                2
2                   2                                2
2                                                    2
2                         2                          2
2                         2                          2
222222222222222222222222222222222222222222222222222222
