1222e2222222222222222222222222222223555555555555555
4                                 f6555555555555555
4                             w    6555555555555555
4r      x                          6555555555555555
4d                                 z222235555555555
788888q                                 65555555555
5555554        x                        65555555555
5555554                     w           65555555555
5555554                                 65555555555
5555554                                 65555555555
555555788888888888888888888888888888888895555555555
555555555555555555555555555555555555555555555555555
555555555555555555555555555555555555555555555555555
555555555555555555555555555555555555555555555555555
555555555555555555555555555555555555555555555555555
555555555555555555555555555555555555555555555555555
555555555555555555555555555555555555555555555555555
555555555555555555555555555555555555555555555555555
