5555555555555555555555555555555555555555555555555555555555555555555555555555555555555555555555
5555555555555555555555555555555555555555555555555555555555555555555555555555555555555555555555
5555555555555555555555555555555555555555555555555555555555555555555555555555555555555555555555
5555555555555555555555555555555555555555555555555555555555555555555555555555555555555555555555
5555555555555555555555555555555555555555555555555555555555555555555555555555555555555555555555
5555555555555555555555555555555555555555555555555555555555555555555555555555555555555555555555
5555555555555555555555555555555555551222222355555555555555555555555555555555555555555555555555
5555555555551222222222222222222355554      z23555555555555555555555555122222235555555555555555
555555555512a                  z2222a        z222355551222222222235512a      65512222355555555
5555555512a                                      z2222a          6554        z22a    z23555555
555555554                                                 x      612a   w              6555555
555555554        sq                                              za                    6555555
555555554      22278q                                                                  6555555
555555554        65578q        w                                                       6555555
555555554     0  z2312a                 0                                            x 6555555
555555554          64                          s88q                                  s89555555
555555554        s894                          z222228q                sq            655555555
555555554        z22a              22                za                za            655555555
555555554                                           w                                655555555
555555554                                                        2222                655555555
555555554                                      sq                                    655555555
555555554                                    222a                            w     s8955555555
555555554                                                     w                  s895555555555
555555554                                    w                                   z235555555555
555555554                                                                          z2355555555
555555554                            x                                               655555555
555555554                                            sq                      sq      655555555
555555554   x228822      w                           67888q      s88q      s8978q    655555555
555555554      za                                    z2312a    2225578q    z2312a   x655555555
5555555578q                                            64        6555578q    za      655555555
55555555554                                            zax       z222312a            655555555
55555555554                                                          za              655555555
55555555554                                        228822                          s8955555555
5555555512a                          0               za                            z2355555555
555555554                                                                            655555555
55555512a            x                         x                    w                655555555
5555554                                                                  s88q        655555555
5555554 w                                                      sq      s89554      s8955555555
55555578q                                                    2227888888955554      65555555555
555555554          sq                    s888888q              z2222222355554      z2355555555
5555555578q      s897888q        x     222555512a                      z23554 w      655555555
55555555554      6555512a                65512a    s8888q                z22a        655555555
5555555555222888895512a                  612a      6555578q                          655555555
55555555554  z235512a                    za      s895555557888q                      655555555
55555555554    6554 0                     x      65555555555557888888888q            655555555
55555555554    65578q                        s888955555555555555555555557888q      s8955555555
555555555578888955557888888888888888q      s89555555555555555555555555555555788888895555555555
5555555555555555555555555555555555557888888955555555555555555555555555555555555555555555555555
5555555555555555555555555555555555555555555555555555555555555555555555555555555555555555555555
5555555555555555555555555555555555555555555555555555555555555555555555555555555555555555555555
5555555555555555555555555555555555555555555555555555555555555555555555555555555555555555555555
5555555555555555555555555555555555555555555555555555555555555555555555555555555555555555555555
5555555555555555555555555555555555555555555555555555555555555555555555555555555555555555555555
5555555555555555555555555555555555555555555555555555555555555555555555555555555555555555555555
