12222222222222222222355555
4                   655555
4                   655555
4                   655555
4                   $22223
788888ù                  6
5555554                  6
5555554                  6
5555554                  6
5555554                  6
55555518888888888888888889
